original_length,filtered_length
1,1
121,1
121,1
121,1
116,1
116,1
119,1
116,1
116,1
116,1
116,1
116,2